##########
#       @#
# $ $ #  #
# #####  #
# #...   #
#   .  # #
#  ##### #
#  # $ $ #
#        #
##########