#####
#.@##
# $ #
#   #
#####